W,W,W,W,W,W,W,W,W,W,W,W,W,W,W,W,W,W,W,W,W,W,W,W,W,W,W,W,W,W,W,W
W,W,W,W,W,W,W,W,W,W,W,W,W,W,W,W,W,W,W,W,W,W,W,W,W,W,W,W,W,W,W,W
W,W,W,W,W,W,W,W,W,_,_,_,_,_,_,_,_,_,_,_,_,W,W,W,W,W,W,W,W,W,W,W
W,W,W,W,W,W,W,W,W,_,P,_,_,_,_,_,_,_,_,_,_,W,W,W,W,W,W,W,W,W,W,W
W,W,W,W,W,W,W,W,W,_,_,_,_,_,_,_,_,_,_,_,_,W,W,W,W,W,W,W,W,W,W,W
W,W,W,W,W,W,W,W,W,W,W,W,W,W,W,W,W,W,_,_,_,W,W,W,W,W,W,W,W,W,W,W
W,W,W,W,W,W,W,W,W,W,W,W,W,W,W,W,W,W,_,_,_,W,W,W,W,W,W,W,W,W,W,W
W,W,W,W,W,W,W,W,W,W,W,W,W,W,W,W,W,W,_,_,_,W,W,W,W,W,W,W,W,W,W,W
W,W,W,W,W,W,W,W,W,W,W,W,W,W,W,W,W,W,_,_,_,W,W,W,W,W,W,W,W,W,W,W
W,W,W,W,W,W,W,W,W,W,W,W,W,W,W,W,W,W,_,_,_,W,W,W,W,W,W,W,W,W,W,W
W,W,W,W,W,W,W,W,W,W,W,W,W,W,W,W,W,W,_,_,_,W,W,W,W,W,W,W,W,W,W,W
W,W,W,W,W,W,W,W,W,W,W,W,W,W,W,W,W,W,_,_,_,W,W,W,W,W,W,W,W,W,W,W
W,W,W,W,W,W,W,W,W,W,W,W,W,W,W,W,W,W,_,_,_,W,W,W,W,W,W,W,W,W,W,W
W,W,W,W,W,W,W,W,W,_,_,_,_,_,_,_,_,_,_,_,_,W,W,W,W,W,W,W,W,W,W,W
W,W,W,W,W,W,W,W,W,_,E,_,_,_,_,_,_,_,_,_,_,W,W,W,W,W,W,W,W,W,W,W
W,W,W,W,W,W,W,W,W,_,_,_,_,_,_,_,_,_,_,_,_,W,W,W,W,W,W,W,W,W,W,W
W,W,W,W,W,W,W,W,W,W,W,W,W,W,W,W,W,W,W,W,W,W,W,W,W,W,W,W,W,W,W,W
W,W,W,W,W,W,W,W,W,W,W,W,W,W,W,W,W,W,W,W,W,W,W,W,W,W,W,W,W,W,W,W