W,W,W,W,W,W,W,W,W,W,W,W,W,W,W,W,W,W,W,W,W,W,W,W,W,W,W,W,W,W,W,W
W,_,_,_,_,_,_,_,_,_,_,_,_,_,_,_,_,_,_,_,_,_,_,_,_,_,_,_,_,_,_,W
W,_,_,_,_,_,_,_,_,_,_,_,_,_,_,_,_,_,_,_,_,_,_,_,_,_,_,_,_,_,_,W
W,_,_,_,_,_,_,_,_,_,_,_,_,_,_,_,_,_,_,_,_,_,_,_,_,_,_,_,_,_,_,W
W,_,_,_,_,_,_,_,_,_,_,_,_,_,_,_,_,_,_,_,_,_,_,_,_,_,_,_,_,_,_,W
W,_,_,_,_,_,_,_,_,_,_,_,_,_,_,_,_,_,_,_,_,_,E,_,_,_,_,_,_,_,_,W
W,_,_,_,_,_,_,_,_,_,_,_,_,_,_,_,_,_,_,_,_,_,E,E,_,_,_,_,_,_,_,W
W,_,_,_,_,_,_,_,_,_,_,_,_,_,_,_,_,_,_,_,_,_,E,_,E,_,_,_,_,_,_,W
W,_,P,_,_,_,_,_,_,_,_,_,_,_,_,_,_,_,_,_,_,_,E,E,_,E,_,_,_,_,_,W
W,_,_,_,_,_,_,_,_,_,_,_,_,_,_,_,_,_,_,_,_,_,E,_,E,_,_,_,_,_,_,W
W,_,_,_,_,_,_,_,_,_,_,_,_,_,_,_,_,_,_,_,_,_,E,E,_,_,_,_,_,_,_,W
W,_,_,_,_,_,_,_,_,_,_,_,_,_,_,_,_,_,_,_,_,_,E,_,_,_,_,_,_,_,_,W
W,_,_,_,_,_,_,_,_,_,_,_,_,_,_,_,_,_,_,_,_,_,_,_,_,_,_,_,_,_,_,W
W,_,_,_,_,_,_,_,_,_,_,_,_,_,_,_,_,_,_,_,_,_,_,_,_,_,_,_,_,_,_,W
W,_,_,_,_,_,_,_,_,_,_,_,_,_,_,_,_,_,_,_,_,_,_,_,_,_,_,_,_,_,_,W
W,_,_,_,_,_,_,_,_,_,_,_,_,_,_,_,_,_,_,_,_,_,_,_,_,_,_,_,_,_,_,W
W,_,_,_,_,_,_,_,_,_,_,_,_,_,_,_,_,_,_,_,_,_,_,_,_,_,_,_,_,_,_,W
W,W,W,W,W,W,W,W,W,W,W,W,W,W,W,W,W,W,W,W,W,W,W,W,W,W,W,W,W,W,W,W