W,W,W,W,W,W,W,W,W,W,W,W,W,W,W,W,W,W,W,W,W,W,W,W,W,W,W,W,W,W,W,W
W,_,_,_,_,_,_,_,_,_,_,_,_,_,_,_,_,_,_,_,_,_,_,_,_,_,_,_,_,_,_,W
W,_,_,_,_,_,_,_,_,_,_,_,_,_,_,_,_,_,_,_,_,_,_,_,_,_,_,_,_,_,_,W
W,_,_,_,_,_,_,_,_,_,_,_,_,_,_,_,_,_,_,_,_,_,E,_,_,_,_,_,_,_,_,W
W,_,_,_,_,_,_,_,_,_,_,_,_,_,_,_,_,_,_,_,_,_,E,_,_,_,_,_,_,_,_,W
W,_,_,_,_,_,_,_,_,_,_,_,_,_,_,_,_,_,_,_,_,_,E,_,_,_,_,_,_,_,_,W
W,_,_,_,_,_,_,_,_,_,_,_,_,_,_,_,_,_,_,_,_,_,_,_,_,_,_,_,_,_,_,W
W,_,_,_,_,_,_,_,_,_,_,_,W,W,W,W,W,W,W,W,W,W,W,W,W,W,W,W,W,W,W,W
W,_,_,_,P,_,_,_,_,_,W,W,W,W,W,W,W,W,W,W,W,W,W,W,W,W,W,W,W,W,W,W
W,_,_,_,_,_,_,_,_,_,_,_,W,W,W,W,W,W,W,W,W,W,W,W,W,W,W,W,W,W,W,W
W,_,_,_,_,_,_,_,_,_,_,_,_,_,_,_,_,_,_,_,_,_,_,_,_,_,_,_,_,_,_,W
W,_,_,_,_,_,_,_,_,_,_,_,_,_,_,_,_,_,_,_,_,_,E,_,_,_,_,_,_,_,_,W
W,_,_,_,_,_,_,_,_,_,_,_,_,_,_,_,_,_,_,_,_,_,E,_,_,_,_,_,_,_,_,W
W,_,_,_,_,_,_,_,_,_,_,_,_,_,_,_,_,_,_,_,_,_,E,_,_,_,_,_,_,_,_,W
W,_,_,_,_,_,_,_,_,_,_,_,_,_,_,_,_,_,_,_,_,_,_,_,_,_,_,_,_,_,_,W
W,_,_,_,_,_,_,_,_,_,_,_,_,_,_,_,_,_,_,_,_,_,_,_,_,_,_,_,_,_,_,W
W,_,_,_,_,_,_,_,_,_,_,_,_,_,_,_,_,_,_,_,_,_,_,_,_,_,_,_,_,_,_,W
W,W,W,W,W,W,W,W,W,W,W,W,W,W,W,W,W,W,W,W,W,W,W,W,W,W,W,W,W,W,W,W